Rk,Player,Pos,Age,Tm,G,GS,MP,FG,FGA,FG%,3P,3PA,3P%,2P,2PA,2P%,eFG%,FT,FTA,FT%,ORB,DRB,TRB,AST,STL,BLK,TOV,PF,PTS
1,Jayson Tatum,PF,24,BOS,14,14,525,144,293,0.491,49,133,0.368,95,160,0.594,0.575,110,127,0.866,11,93,104,54,13,20,33,31,447
2,Kevin Durant,PF,34,BRK,14,14,518,143,273,0.524,24,67,0.358,119,206,0.578,0.568,118,129,0.915,6,87,93,74,13,27,46,35,428
3,Luka Dončić,PG,23,DAL,12,12,443,140,282,0.496,28,98,0.286,112,184,0.609,0.546,104,139,0.748,12,92,104,97,24,8,39,39,412
4,Shai Gilgeous-Alexander,SG,24,OKC,13,13,467,151,280,0.539,14,37,0.378,137,243,0.564,0.564,94,100,0.94,11,46,57,76,27,19,44,32,410
5,Stephen Curry,PG,34,GSW,13,13,449,137,262,0.523,65,150,0.433,72,112,0.643,0.647,70,76,0.921,9,77,86,83,14,1,33,26,409
6,Trae Young,PG,24,ATL,13,13,456,110,291,0.378,30,97,0.309,80,194,0.412,0.43,100,110,0.909,11,30,41,121,11,2,47,17,350
7,Donovan Mitchell,SG,26,CLE,11,11,430,123,240,0.513,46,106,0.434,77,134,0.575,0.608,56,64,0.875,11,41,52,67,15,7,37,32,348
8,Devin Booker,SG,26,PHO,13,13,478,124,260,0.477,30,80,0.375,94,180,0.522,0.535,67,78,0.859,13,49,62,72,15,6,35,32,345
9,Ja Morant,PG,23,MEM,12,12,395,121,252,0.48,25,61,0.41,96,191,0.503,0.53,78,99,0.788,13,59,72,84,12,4,48,23,345
10,DeMar DeRozan,SF,33,CHI,14,14,473,114,224,0.509,4,20,0.2,110,204,0.539,0.518,102,115,0.887,5,50,55,59,16,6,32,36,334
11,Jaylen Brown,SF,26,BOS,13,13,478,123,255,0.482,30,89,0.337,93,166,0.56,0.541,54,65,0.831,12,76,88,45,12,6,40,38,330
12,Lauri Markkanen,SF,25,UTA,15,15,496,122,232,0.526,31,90,0.344,91,142,0.641,0.593,52,62,0.839,32,97,129,33,8,14,30,26,327
13,Joel Embiid,C,28,PHI,10,10,352,108,201,0.537,9,38,0.237,99,163,0.607,0.56,98,118,0.831,16,85,101,41,6,18,42,34,323
14,Tyrese Maxey,SG,22,PHI,14,14,525,117,261,0.448,40,98,0.408,77,163,0.472,0.525,45,60,0.75,6,42,48,61,15,3,29,35,319
15,Paul George,SF,32,LAC,13,13,457,112,245,0.457,36,104,0.346,76,141,0.539,0.531,58,70,0.829,6,73,79,59,20,7,44,34,318
16,Giannis Antetokounmpo,PF,28,MIL,10,10,326,111,211,0.526,8,33,0.242,103,178,0.579,0.545,83,129,0.643,18,100,118,52,11,13,38,32,313
17,Jalen Green,SG,20,HOU,14,14,481,110,254,0.433,42,112,0.375,68,142,0.479,0.516,46,58,0.793,8,50,58,44,11,4,38,21,308
18,Bojan Bogdanović,PF,33,DET,15,15,468,98,196,0.5,42,101,0.416,56,95,0.589,0.607,64,73,0.877,6,47,53,32,6,0,31,30,302
19,Dejounte Murray,SG,26,ATL,14,14,512,121,267,0.453,26,81,0.321,95,186,0.511,0.502,33,38,0.868,12,78,90,109,29,6,32,25,301
20,Keldon Johnson,SF,23,SAS,13,13,426,101,223,0.453,48,114,0.421,53,109,0.486,0.561,48,62,0.774,8,56,64,45,12,1,37,20,298
21,Karl-Anthony Towns,PF,27,MIN,14,14,480,106,206,0.515,29,79,0.367,77,127,0.606,0.585,57,64,0.891,27,103,130,73,9,9,41,54,298
22,Desmond Bane,SG,24,MEM,12,12,403,99,213,0.465,46,102,0.451,53,111,0.477,0.573,52,57,0.912,6,53,59,57,7,3,27,29,296
23,Anthony Edwards,SG,21,MIN,14,14,505,111,243,0.457,33,97,0.34,78,146,0.534,0.525,38,57,0.667,7,72,79,52,15,3,43,44,293
24,Anthony Davis,C,29,LAL,12,12,414,116,214,0.542,4,16,0.25,112,198,0.566,0.551,55,70,0.786,43,91,134,30,16,22,19,37,291
25,De'Aaron Fox,PG,25,SAC,11,11,360,108,197,0.548,21,56,0.375,87,141,0.617,0.602,44,53,0.83,7,49,56,66,14,5,35,32,281
26,Kelly Oubre Jr.,SF,27,CHO,15,15,462,100,244,0.41,38,115,0.33,62,129,0.481,0.488,37,53,0.698,16,56,72,18,23,5,18,47,275
27,Jordan Clarkson,SG,30,UTA,15,15,455,99,231,0.429,46,117,0.393,53,114,0.465,0.528,28,35,0.8,23,41,64,71,5,8,35,29,272
28,Julius Randle,PF,28,NYK,13,13,435,90,196,0.459,25,75,0.333,65,121,0.537,0.523,66,87,0.759,33,85,118,44,8,3,39,47,271
29,Nikola Jokić,C,27,DEN,13,13,404,103,170,0.606,8,28,0.286,95,142,0.669,0.629,56,64,0.875,20,103,123,116,19,8,41,35,270
30,Kevin Porter Jr.,PG,22,HOU,14,14,487,92,225,0.409,25,77,0.325,67,148,0.453,0.464,60,82,0.732,21,60,81,79,19,4,55,42,269
31,Bam Adebayo,C,25,MIA,14,14,490,104,196,0.531,0,5,0,104,191,0.545,0.531,59,69,0.855,34,94,128,47,17,11,50,48,267
32,Kristaps Porziņģis,PF,27,WAS,13,13,403,92,188,0.489,29,75,0.387,63,113,0.558,0.566,54,67,0.806,29,77,106,31,10,18,23,43,267
33,Franz Wagner,SF,21,ORL,14,14,477,105,213,0.493,13,53,0.245,92,160,0.575,0.523,38,44,0.864,15,43,58,62,11,4,39,31,261
34,OG Anunoby,SF,25,TOR,15,15,532,96,209,0.459,27,75,0.36,69,134,0.515,0.524,41,50,0.82,21,71,92,28,40,15,35,50,260
35,Paolo Banchero,PF,20,ORL,11,11,381,89,193,0.461,11,43,0.256,78,150,0.52,0.49,70,91,0.769,9,82,91,40,8,10,33,26,259
36,Jimmy Butler,SF,33,MIA,12,12,426,81,168,0.482,11,29,0.379,70,139,0.504,0.515,86,96,0.896,26,59,85,74,22,3,17,19,259
37,Zion Williamson,PF,22,NOP,11,11,354,99,175,0.566,3,6,0.5,96,169,0.568,0.574,58,81,0.716,23,47,70,43,12,3,30,30,259
38,Kyle Kuzma,PF,27,WAS,14,14,461,95,209,0.455,28,88,0.318,67,121,0.554,0.522,39,53,0.736,12,99,111,38,3,8,32,37,257
39,Jalen Brunson,PG,26,NYK,13,13,425,93,189,0.492,15,51,0.294,78,138,0.565,0.532,53,61,0.869,5,41,46,89,15,2,21,31,254
40,LeBron James,PF,38,LAL,10,10,357,100,219,0.457,17,71,0.239,83,148,0.561,0.495,32,48,0.667,18,70,88,69,11,7,34,20,249
41,Jerami Grant,PF,28,POR,12,12,428,82,165,0.497,29,63,0.46,53,102,0.52,0.585,55,72,0.764,11,45,56,32,8,11,27,24,248
42,RJ Barrett,SG,22,NYK,13,13,441,89,208,0.428,22,72,0.306,67,136,0.493,0.481,46,59,0.78,13,57,70,37,7,2,29,28,246
43,Tyrese Haliburton,PG,22,IND,12,12,410,87,180,0.483,36,84,0.429,51,96,0.531,0.583,36,42,0.857,13,44,57,124,22,2,36,16,246
44,Anfernee Simons,SG,23,POR,11,11,398,85,202,0.421,42,115,0.365,43,87,0.494,0.525,33,39,0.846,4,29,33,45,9,2,26,24,245
45,Cade Cunningham,PG,21,DET,12,12,400,93,224,0.415,17,61,0.279,76,163,0.466,0.453,36,43,0.837,12,62,74,72,10,7,39,34,239
46,Bennedict Mathurin,SG,20,IND,12,0,338,73,160,0.456,34,75,0.453,39,85,0.459,0.563,59,71,0.831,15,32,47,27,5,1,29,27,239
47,Jordan Poole,SG,23,GSW,14,3,400,81,185,0.438,34,98,0.347,47,87,0.54,0.53,43,52,0.827,3,22,25,60,17,2,42,33,239
48,Andrew Wiggins,SF,27,GSW,13,13,434,92,187,0.492,31,80,0.388,61,107,0.57,0.575,23,31,0.742,21,54,75,31,18,13,17,37,238
49,Saddiq Bey,SF,23,DET,15,14,474,72,173,0.416,25,83,0.301,47,90,0.522,0.488,66,72,0.917,17,53,70,23,13,3,21,26,235
50,CJ McCollum,SG,31,NOP,13,13,467,93,238,0.391,24,86,0.279,69,152,0.454,0.441,22,28,0.786,13,58,71,82,18,8,28,25,232
51,Gary Trent Jr.,SG,24,TOR,14,14,448,81,195,0.415,31,95,0.326,50,100,0.5,0.495,39,50,0.78,10,17,27,20,19,3,14,18,232
52,Damian Lillard,PG,32,POR,8,8,283,66,141,0.468,31,78,0.397,35,63,0.556,0.578,66,76,0.868,9,31,40,48,5,2,34,12,229
53,Wendell Carter Jr.,C,23,ORL,14,14,459,78,153,0.51,17,46,0.37,61,107,0.57,0.565,55,67,0.821,32,96,128,44,8,8,34,44,228
54,Buddy Hield,SG,30,IND,12,12,378,82,175,0.469,49,120,0.408,33,55,0.6,0.609,13,15,0.867,15,51,66,38,9,5,23,26,226
55,Jaden Ivey,SG,20,DET,14,14,442,80,182,0.44,21,62,0.339,59,120,0.492,0.497,45,61,0.738,18,52,70,57,19,5,36,41,226
56,Nikola Vučević,C,32,CHI,14,14,436,84,179,0.469,24,61,0.393,60,118,0.508,0.536,32,35,0.914,37,124,161,40,3,11,34,34,224
57,Pascal Siakam,C,28,TOR,9,9,321,80,167,0.479,13,38,0.342,67,129,0.519,0.518,50,69,0.725,16,68,84,69,8,5,24,28,223
58,Spencer Dinwiddie,PG,29,DAL,12,12,397,81,165,0.491,39,85,0.459,42,80,0.525,0.609,21,26,0.808,3,39,42,56,14,2,21,30,222
59,De'Andre Hunter,SF,25,ATL,14,14,419,82,176,0.466,20,54,0.37,62,122,0.508,0.523,35,45,0.778,10,44,54,14,4,2,19,48,219
60,Zach LaVine,SG,27,CHI,10,10,338,76,171,0.444,30,78,0.385,46,93,0.495,0.532,37,44,0.841,5,34,39,41,13,1,22,25,219
61,P.J. Washington,PF,24,CHO,15,15,473,83,195,0.426,24,75,0.32,59,120,0.492,0.487,28,36,0.778,19,49,68,26,9,16,26,42,218
62,Michael Porter Jr.,SF,24,DEN,12,12,349,78,157,0.497,43,89,0.483,35,68,0.515,0.634,17,20,0.85,16,61,77,15,8,3,12,35,216
63,Kyrie Irving,PG,30,BRK,8,8,309,78,172,0.453,21,75,0.28,57,97,0.588,0.515,38,41,0.927,6,35,41,41,11,9,19,24,215
64,Domantas Sabonis,PF,26,SAC,12,12,384,78,140,0.557,3,14,0.214,75,126,0.595,0.568,56,79,0.709,31,105,136,75,11,6,27,47,215
65,Collin Sexton,SG,24,UTA,15,1,332,71,150,0.473,17,45,0.378,54,105,0.514,0.53,51,64,0.797,14,29,43,27,11,1,25,33,210
66,Tobias Harris,PF,30,PHI,14,14,472,78,169,0.462,29,73,0.397,49,96,0.51,0.547,21,27,0.778,15,72,87,40,22,8,15,30,206
67,Max Strus,SF,26,MIA,14,7,460,75,165,0.455,42,111,0.378,33,54,0.611,0.582,14,17,0.824,10,44,54,27,11,5,14,36,206
68,Mikal Bridges,SF,26,PHO,13,13,478,78,142,0.549,16,37,0.432,62,105,0.59,0.606,31,35,0.886,16,51,67,40,13,13,15,26,203
69,D'Angelo Russell,PG,26,MIN,14,14,421,72,175,0.411,27,82,0.329,45,93,0.484,0.489,31,42,0.738,11,37,48,87,18,8,42,28,202
70,Brook Lopez,C,34,MIL,13,13,409,76,158,0.481,28,81,0.346,48,77,0.623,0.57,21,26,0.808,27,55,82,13,8,32,21,33,201
71,Kevin Huerter,SG,24,SAC,12,12,382,66,132,0.5,45,88,0.511,21,44,0.477,0.67,22,33,0.667,1,34,35,38,11,5,16,25,199
72,James Harden,SG,33,PHI,9,9,331,63,143,0.441,20,60,0.333,43,83,0.518,0.51,52,56,0.929,5,58,63,90,10,6,26,18,198
73,Luguentz Dort,SG,23,OKC,14,14,428,69,176,0.392,21,79,0.266,48,97,0.495,0.452,38,49,0.776,20,41,61,32,19,4,15,48,197
74,Tyler Herro,SG,23,MIA,10,10,314,72,154,0.468,24,64,0.375,48,90,0.533,0.545,28,31,0.903,6,58,64,26,7,6,21,16,196
75,Jrue Holiday,PG,32,MIL,10,10,331,74,168,0.44,24,67,0.358,50,101,0.495,0.512,24,28,0.857,13,44,57,79,15,7,29,17,196
76,Russell Westbrook,PG,34,LAL,12,3,352,68,165,0.412,18,53,0.34,50,112,0.446,0.467,42,52,0.808,14,52,66,86,14,5,45,32,196
77,Devin Vassell,SG,22,SAS,10,8,309,73,160,0.456,30,73,0.411,43,87,0.494,0.55,19,25,0.76,1,40,41,35,8,4,13,11,195
78,Bradley Beal,SG,29,WAS,9,9,316,74,143,0.517,13,40,0.325,61,103,0.592,0.563,33,36,0.917,6,26,32,51,8,7,24,18,194
79,Jamal Murray,PG,25,DEN,12,12,344,78,178,0.438,19,55,0.345,59,123,0.48,0.492,19,26,0.731,8,34,42,52,12,0,25,9,194
80,Brandon Ingram,SF,25,NOP,9,9,293,71,147,0.483,15,32,0.469,56,115,0.487,0.534,36,44,0.818,5,47,52,36,8,8,28,25,193
81,Alperen Şengün,C,20,HOU,12,9,318,70,122,0.574,3,15,0.2,67,107,0.626,0.586,50,64,0.781,42,62,104,23,8,11,25,42,193
82,Evan Mobley,PF,21,CLE,13,13,441,78,141,0.553,2,11,0.182,76,130,0.585,0.56,34,48,0.708,31,67,98,28,12,18,31,40,192
83,Aaron Gordon,PF,27,DEN,13,13,377,72,125,0.576,11,35,0.314,61,90,0.678,0.62,33,53,0.623,29,60,89,33,7,11,16,19,188
84,Scottie Barnes,PF,21,TOR,14,14,449,76,176,0.432,17,52,0.327,59,124,0.476,0.48,18,25,0.72,25,66,91,68,13,10,29,22,187
85,Kyle Lowry,PG,36,MIA,14,14,494,55,138,0.399,30,87,0.345,25,51,0.49,0.507,44,49,0.898,9,57,66,81,16,6,31,37,184
86,Kelly Olynyk,PF,31,UTA,15,15,402,65,119,0.546,23,46,0.5,42,73,0.575,0.643,31,40,0.775,18,47,65,47,19,7,38,65,184
87,Fred VanVleet,PG,28,TOR,10,10,365,60,147,0.408,35,83,0.422,25,64,0.391,0.527,29,35,0.829,6,31,37,68,23,7,14,24,184
88,Malik Beasley,SG,26,UTA,15,2,384,65,152,0.428,42,100,0.42,23,52,0.442,0.566,11,12,0.917,10,42,52,18,15,2,11,16,183
89,Lonnie Walker IV,SG,24,LAL,11,11,342,68,144,0.472,20,56,0.357,48,88,0.545,0.542,26,32,0.813,5,22,27,19,12,7,12,23,182
90,Isaiah Stewart,C,21,DET,15,15,407,57,120,0.475,18,54,0.333,39,66,0.591,0.55,48,65,0.738,43,97,140,19,8,11,16,45,180
91,Jonas Valančiūnas,C,30,NOP,13,13,316,65,129,0.504,6,16,0.375,59,113,0.522,0.527,44,52,0.846,43,88,131,27,7,4,17,28,180
92,Caris LeVert,SG,28,CLE,13,13,451,61,156,0.391,25,59,0.424,36,97,0.371,0.471,32,41,0.78,16,46,62,69,10,2,27,34,179
93,John Collins,PF,25,ATL,14,14,442,68,138,0.493,10,41,0.244,58,97,0.598,0.529,31,33,0.939,23,89,112,14,10,18,19,46,177
94,Marcus Morris,PF,33,LAC,12,12,371,71,141,0.504,28,67,0.418,43,74,0.581,0.603,7,7,1,6,65,71,26,10,4,13,31,177
95,Bobby Portis,PF,27,MIL,13,3,344,70,158,0.443,16,51,0.314,54,107,0.505,0.494,18,23,0.783,36,106,142,26,5,3,14,19,174
96,Norman Powell,SG,29,LAC,14,5,352,60,139,0.432,15,52,0.288,45,87,0.517,0.486,37,47,0.787,5,33,38,20,13,4,28,27,172
97,Dillon Brooks,SG,27,MEM,11,11,321,66,163,0.405,24,62,0.387,42,101,0.416,0.479,15,21,0.714,5,34,39,23,7,2,16,36,171
98,Jakob Poeltl,C,27,SAS,14,14,400,75,118,0.636,0,0,,75,118,0.636,0.636,20,43,0.465,53,84,137,50,13,17,33,30,170
99,Terry Rozier,PG,28,CHO,8,8,286,64,167,0.383,26,78,0.333,38,89,0.427,0.461,16,19,0.842,12,29,41,41,5,3,18,11,170
100,Jarrett Allen,C,24,CLE,12,12,390,69,124,0.556,0,2,0,69,122,0.566,0.556,30,39,0.769,42,96,138,14,5,15,17,27,168
101,Rudy Gobert,C,30,MIN,12,12,388,61,99,0.616,0,2,0,61,97,0.629,0.616,46,67,0.687,50,105,155,12,7,19,20,34,168
102,Nic Claxton,C,23,BRK,14,14,384,76,105,0.724,0,1,0,76,104,0.731,0.724,15,40,0.375,41,86,127,17,11,29,21,38,167
103,Bol Bol,PF,23,ORL,14,9,336,64,101,0.634,12,25,0.48,52,76,0.684,0.693,23,27,0.852,20,86,106,9,2,27,29,22,163
104,Josh Giddey,SG,20,OKC,11,11,333,70,153,0.458,12,38,0.316,58,115,0.504,0.497,11,15,0.733,16,64,80,61,5,6,40,24,163
105,Klay Thompson,SG,32,GSW,11,11,314,59,168,0.351,35,106,0.33,24,62,0.387,0.455,9,12,0.75,3,34,37,27,6,5,18,19,162
106,Deandre Ayton,C,24,PHO,11,11,300,72,125,0.576,3,8,0.375,69,117,0.59,0.588,14,19,0.737,30,55,85,17,7,6,24,37,161
107,Tre Jones,PG,23,SAS,13,13,396,57,138,0.413,13,31,0.419,44,107,0.411,0.46,33,36,0.917,9,41,50,86,18,3,26,28,160
108,Clint Capela,C,28,ATL,14,14,383,72,119,0.605,0,0,,72,119,0.605,0.605,15,28,0.536,62,104,166,10,9,21,16,27,159
109,Marcus Smart,PG,28,BOS,14,14,458,57,136,0.419,21,72,0.292,36,64,0.563,0.496,24,29,0.828,4,41,45,99,16,4,23,44,159
110,Christian Wood,PF,27,DAL,10,0,247,58,101,0.574,13,31,0.419,45,70,0.643,0.639,30,44,0.682,13,62,75,8,5,5,24,28,159
111,Rui Hachimura,PF,24,WAS,14,0,329,64,139,0.46,9,30,0.3,55,109,0.505,0.493,21,29,0.724,11,57,68,12,2,8,21,16,158
112,Kevin Love,PF,34,CLE,13,1,276,48,113,0.425,33,81,0.407,15,32,0.469,0.571,29,34,0.853,13,84,97,34,2,3,15,17,158
113,Jaden McDaniels,PF,22,MIN,14,14,414,61,109,0.56,13,36,0.361,48,73,0.658,0.619,22,29,0.759,20,27,47,16,17,18,21,53,157
114,Kenyon Martin Jr.,SF,22,HOU,14,3,352,59,114,0.518,16,49,0.327,43,65,0.662,0.588,20,30,0.667,18,52,70,22,6,8,17,29,154
115,Tyus Jones,PG,26,MEM,14,2,326,63,140,0.45,19,55,0.345,44,85,0.518,0.518,8,13,0.615,4,20,24,55,10,1,16,7,153
116,Ayo Dosunmu,PG,23,CHI,13,13,394,61,125,0.488,18,51,0.353,43,74,0.581,0.56,12,13,0.923,6,44,50,42,11,4,22,32,152
117,Jaylen Nowell,SG,23,MIN,14,0,254,60,144,0.417,17,55,0.309,43,89,0.483,0.476,15,19,0.789,8,31,39,32,7,2,13,21,152
118,Malcolm Brogdon,PG,30,BOS,11,0,253,53,111,0.477,14,38,0.368,39,73,0.534,0.541,31,36,0.861,10,32,42,39,6,2,22,14,151
119,Mike Conley,PG,35,UTA,14,14,424,51,128,0.398,27,72,0.375,24,56,0.429,0.504,22,29,0.759,5,27,32,114,14,4,22,23,151
120,Trey Murphy III,SF,22,NOP,13,4,371,50,107,0.467,28,71,0.394,22,36,0.611,0.598,21,22,0.955,17,41,58,18,12,5,10,24,149
121,Darius Garland,PG,23,CLE,7,7,242,48,122,0.393,22,54,0.407,26,68,0.382,0.484,30,38,0.789,4,12,16,56,10,1,22,18,148
122,Reggie Jackson,PG,32,LAC,14,14,405,57,138,0.413,18,59,0.305,39,79,0.494,0.478,16,17,0.941,4,27,31,60,9,1,30,26,148
123,Jalen McDaniels,SF,25,CHO,15,1,395,55,125,0.44,20,50,0.4,35,75,0.467,0.52,18,21,0.857,17,58,75,34,17,10,20,39,148
124,Nick Richards,C,25,CHO,15,0,286,55,85,0.647,0,0,,55,85,0.647,0.647,37,50,0.74,42,46,88,12,1,12,12,33,147
125,Ivica Zubac,C,25,LAC,14,14,424,59,97,0.608,0,1,0,59,96,0.615,0.608,29,46,0.63,39,113,152,18,8,30,31,38,147
126,Eric Gordon,SG,34,HOU,12,12,362,50,112,0.446,22,61,0.361,28,51,0.549,0.545,24,29,0.828,2,21,23,37,9,5,22,11,146
127,Chris Boucher,PF,30,TOR,12,0,268,52,102,0.51,14,40,0.35,38,62,0.613,0.578,27,37,0.73,26,39,65,8,11,12,13,36,145
128,Mason Plumlee,C,32,CHO,15,15,399,56,88,0.636,0,0,,56,88,0.636,0.636,33,56,0.589,44,89,133,61,9,8,28,51,145
129,Josh Richardson,SG,29,SAS,13,2,304,47,115,0.409,25,66,0.379,22,49,0.449,0.517,26,31,0.839,4,27,31,38,9,2,26,26,145
130,Tre Mann,PG,21,OKC,13,4,313,55,137,0.401,24,72,0.333,31,65,0.477,0.489,10,16,0.625,10,30,40,29,12,1,13,23,144
131,Royce O'Neale,SF,29,BRK,14,14,509,50,134,0.373,34,81,0.42,16,53,0.302,0.5,10,14,0.714,16,49,65,57,19,9,17,48,144
132,Kentavious Caldwell-Pope,SG,29,DEN,12,12,372,50,100,0.5,30,55,0.545,20,45,0.444,0.65,12,16,0.75,4,39,43,32,18,4,15,24,142
133,Malik Monk,SG,24,SAC,12,0,262,46,112,0.411,24,66,0.364,22,46,0.478,0.518,26,28,0.929,5,22,27,51,5,4,20,20,142
134,Goran Dragić,PG,36,CHI,14,0,270,53,116,0.457,22,47,0.468,31,69,0.449,0.552,13,17,0.765,8,18,26,50,4,3,20,20,141
135,Keegan Murray,SF,22,SAC,11,9,352,53,116,0.457,27,70,0.386,26,46,0.565,0.573,7,9,0.778,8,33,41,13,12,9,19,28,140
136,Gordon Hayward,SF,32,CHO,8,8,248,50,106,0.472,10,28,0.357,40,78,0.513,0.519,29,37,0.784,4,30,34,33,6,2,22,6,139
137,Santi Aldama,PF,22,MEM,14,14,388,53,114,0.465,17,51,0.333,36,63,0.571,0.539,14,22,0.636,26,61,87,13,13,17,10,39,137
138,Doug McDermott,SF,31,SAS,14,0,296,50,113,0.442,28,68,0.412,22,45,0.489,0.566,9,14,0.643,4,25,29,18,1,3,15,21,137
139,Gabe Vincent,PG,26,MIA,14,0,362,48,119,0.403,21,66,0.318,27,53,0.509,0.492,20,24,0.833,4,28,32,42,13,2,20,37,137
140,Brandon Clarke,PF,26,MEM,14,1,253,54,85,0.635,0,5,0,54,80,0.675,0.635,27,37,0.73,13,41,54,19,4,12,17,36,135
141,Dennis Smith Jr.,PG,25,CHO,13,11,383,58,125,0.464,10,28,0.357,48,97,0.495,0.504,6,11,0.545,9,38,47,80,25,8,21,32,132
142,Jalen Smith,PF,22,IND,12,12,286,50,113,0.442,16,49,0.327,34,64,0.531,0.513,16,24,0.667,21,70,91,13,2,9,19,27,132
143,Harrison Barnes,PF,30,SAC,12,12,381,41,99,0.414,9,40,0.225,32,59,0.542,0.46,40,49,0.816,14,51,65,25,9,3,13,16,131
144,Jabari Smith Jr.,PF,19,HOU,13,13,384,43,136,0.316,22,74,0.297,21,62,0.339,0.397,23,28,0.821,19,68,87,11,5,13,15,47,131
145,Obi Toppin,PF,24,NYK,13,0,231,50,104,0.481,22,55,0.4,28,49,0.571,0.587,9,9,1,11,40,51,14,8,3,14,12,131
146,Bruce Brown,PG,26,DEN,13,3,360,51,113,0.451,16,41,0.39,35,72,0.486,0.522,12,15,0.8,16,35,51,54,10,7,19,24,130
147,Jusuf Nurkić,C,28,POR,10,10,295,48,97,0.495,6,11,0.545,42,86,0.488,0.526,28,32,0.875,31,81,112,25,9,8,25,31,130
148,Cameron Payne,PG,28,PHO,11,3,240,50,120,0.417,20,52,0.385,30,68,0.441,0.5,10,12,0.833,3,25,28,42,11,1,21,19,130
149,Patrick Williams,PF,21,CHI,14,14,352,51,110,0.464,15,40,0.375,36,70,0.514,0.532,13,14,0.929,17,35,52,11,11,16,21,27,130
150,Tim Hardaway Jr.,SG,30,DAL,11,0,266,39,115,0.339,25,75,0.333,14,40,0.35,0.448,26,29,0.897,1,19,20,22,7,2,11,14,129
151,Will Barton,SG,32,WAS,14,0,334,47,122,0.385,19,56,0.339,28,66,0.424,0.463,14,15,0.933,6,43,49,35,8,4,18,17,127
152,Bones Hyland,PG,22,DEN,9,0,187,40,103,0.388,26,52,0.5,14,51,0.275,0.515,20,26,0.769,1,14,15,33,6,3,18,17,126
153,John Wall,PG,32,LAC,10,0,226,49,113,0.434,9,37,0.243,40,76,0.526,0.473,19,33,0.576,4,19,23,51,11,3,15,17,126
154,Terrence Ross,SG,31,ORL,13,8,343,48,108,0.444,23,56,0.411,25,52,0.481,0.551,6,9,0.667,6,29,35,20,8,3,15,28,125
155,Myles Turner,C,26,IND,7,7,198,38,75,0.507,10,27,0.37,28,48,0.583,0.573,39,46,0.848,11,50,61,10,2,22,13,26,125
156,Derrick White,SG,28,BOS,14,10,358,42,98,0.429,20,50,0.4,22,48,0.458,0.531,21,24,0.875,8,37,45,43,10,12,8,40,125
157,Al Horford,C,36,BOS,11,11,346,48,89,0.539,23,51,0.451,25,38,0.658,0.669,5,8,0.625,13,59,72,25,5,8,8,23,124
158,Jevon Carter,PG,27,MIL,13,13,353,45,107,0.421,22,55,0.4,23,52,0.442,0.523,10,12,0.833,10,22,32,43,21,9,20,40,122
159,Monte Morris,PG,27,WAS,14,14,386,47,113,0.416,13,39,0.333,34,74,0.459,0.473,15,21,0.714,7,47,54,71,10,4,13,15,122
160,Grayson Allen,SG,27,MIL,12,11,305,35,85,0.412,23,54,0.426,12,31,0.387,0.547,28,30,0.933,9,23,32,30,10,3,19,19,121
161,Grant Williams,PF,24,BOS,13,5,367,41,70,0.586,21,43,0.488,20,27,0.741,0.736,18,22,0.818,10,55,65,23,9,8,9,34,121
162,Aleksej Pokusevski,PF,21,OKC,12,8,293,48,104,0.462,16,43,0.372,32,61,0.525,0.538,7,13,0.538,21,50,71,21,10,20,20,21,119
163,Tari Eason,PF,21,HOU,14,0,253,45,103,0.437,12,28,0.429,33,75,0.44,0.495,15,19,0.789,30,37,67,16,22,7,11,32,117
164,Talen Horton-Tucker,SG,22,UTA,15,0,249,44,110,0.4,12,45,0.267,32,65,0.492,0.455,17,22,0.773,9,33,42,38,13,5,13,21,117
165,Georges Niang,PF,29,PHI,14,0,253,40,85,0.471,30,67,0.448,10,18,0.556,0.647,7,7,1,3,23,26,10,5,6,10,25,117
166,Taurean Prince,SF,28,MIN,14,0,278,41,82,0.5,19,45,0.422,22,37,0.595,0.616,16,17,0.941,6,30,36,15,4,3,12,35,117
167,Cedi Osman,SF,27,CLE,13,0,278,40,91,0.44,19,49,0.388,21,42,0.5,0.544,17,24,0.708,3,28,31,24,1,1,11,28,116
168,Josh Hart,SG,27,POR,13,13,472,40,97,0.412,7,23,0.304,33,74,0.446,0.448,28,41,0.683,22,91,113,57,15,2,23,32,115
169,Immanuel Quickley,PG,23,NYK,13,0,278,39,106,0.368,14,50,0.28,25,56,0.446,0.434,22,27,0.815,8,56,64,42,15,2,18,23,114
170,Caleb Martin,PF,27,MIA,13,13,377,45,102,0.441,14,34,0.412,31,68,0.456,0.51,8,11,0.727,25,33,58,24,17,3,11,26,112
171,Larry Nance Jr.,PF,30,NOP,12,0,278,50,75,0.667,4,8,0.5,46,67,0.687,0.693,8,12,0.667,21,47,68,27,10,6,14,27,112
172,Jarred Vanderbilt,PF,23,UTA,13,13,323,47,82,0.573,7,16,0.438,40,66,0.606,0.616,11,17,0.647,31,76,107,35,17,5,23,48,112
173,Austin Reaves,SG,24,LAL,13,4,350,34,71,0.479,13,36,0.361,21,35,0.6,0.57,29,33,0.879,9,33,42,21,6,4,14,16,110
174,Luke Kennard,SG,26,LAC,13,6,295,41,80,0.513,23,48,0.479,18,32,0.563,0.656,3,3,1,4,36,40,8,7,0,15,19,108
175,Cam Reddish,SF,23,NYK,13,5,277,41,93,0.441,13,39,0.333,28,54,0.519,0.511,13,15,0.867,4,20,24,14,9,6,9,22,108
176,Shaedon Sharpe,SG,19,POR,12,4,250,44,85,0.518,12,27,0.444,32,58,0.552,0.588,8,11,0.727,10,21,31,5,4,3,9,25,108
177,Onyeka Okongwu,C,22,ATL,13,0,257,48,72,0.667,0,1,0,48,71,0.676,0.667,10,15,0.667,24,49,73,13,7,11,8,43,106
178,Jalen Suggs,PG,21,ORL,9,8,261,40,95,0.421,10,39,0.256,30,56,0.536,0.474,16,26,0.615,6,21,27,46,15,4,30,35,106
179,Precious Achiuwa,C,23,TOR,12,0,245,36,92,0.391,5,28,0.179,31,64,0.484,0.418,28,33,0.848,24,60,84,16,2,7,15,19,105
180,De'Anthony Melton,PG,24,PHI,12,5,293,42,97,0.433,16,48,0.333,26,49,0.531,0.515,5,7,0.714,14,37,51,32,19,6,11,19,105
181,Troy Brown Jr.,SF,23,LAL,11,9,302,41,92,0.446,14,43,0.326,27,49,0.551,0.522,8,8,1,10,46,56,9,9,0,10,22,104
182,Cameron Johnson,PF,26,PHO,8,8,202,37,83,0.446,22,51,0.431,15,32,0.469,0.578,8,11,0.727,5,22,27,14,9,3,2,14,104
183,Jeremiah Robinson-Earl,PF,22,OKC,13,10,233,40,78,0.513,17,39,0.436,23,39,0.59,0.622,7,11,0.636,15,37,52,9,11,4,6,27,104
184,Draymond Green,PF,32,GSW,13,13,390,44,82,0.537,3,14,0.214,41,68,0.603,0.555,12,19,0.632,9,75,84,86,12,7,31,45,103
185,Sam Hauser,PF,25,BOS,14,0,218,36,71,0.507,28,62,0.452,8,9,0.889,0.704,3,4,0.75,4,23,27,8,4,4,2,18,103
186,Isaiah Jackson,PF,21,IND,12,3,221,40,65,0.615,0,1,0,40,64,0.625,0.615,23,33,0.697,20,45,65,14,6,15,15,32,103
187,Isaiah Hartenstein,C,24,NYK,13,3,326,44,79,0.557,3,14,0.214,41,65,0.631,0.576,11,14,0.786,48,60,108,12,9,16,15,37,102
188,Jeff Green,PF,36,DEN,13,0,258,38,73,0.521,5,18,0.278,33,55,0.6,0.555,20,27,0.741,11,25,36,16,6,3,13,26,101
189,Jose Alvarado,PG,24,NOP,13,2,244,38,81,0.469,18,43,0.419,20,38,0.526,0.58,6,9,0.667,5,21,26,36,12,2,17,26,100
190,Dorian Finney-Smith,PF,29,DAL,12,12,390,37,85,0.435,18,55,0.327,19,30,0.633,0.541,8,11,0.727,14,34,48,9,10,6,15,26,100
191,Jeremy Sochan,PF,19,SAS,13,13,310,43,90,0.478,6,33,0.182,37,57,0.649,0.511,6,10,0.6,15,37,52,19,12,6,15,32,98
192,Terance Mann,SG,26,LAC,14,5,256,40,69,0.58,5,22,0.227,35,47,0.745,0.616,12,18,0.667,8,34,42,22,7,4,12,23,97
193,Deni Avdija,SF,22,WAS,14,11,315,34,88,0.386,11,36,0.306,23,52,0.442,0.449,17,22,0.773,9,52,61,27,9,8,17,41,96
194,Jock Landale,C,27,PHO,13,0,194,37,75,0.493,3,24,0.125,34,51,0.667,0.513,19,24,0.792,23,34,57,11,4,10,9,33,96
195,Chris Paul,PG,37,PHO,10,10,302,28,76,0.368,9,33,0.273,19,43,0.442,0.428,30,34,0.882,5,40,45,94,17,2,15,23,95
196,Joe Harris,SG,31,BRK,12,8,318,36,87,0.414,20,58,0.345,16,29,0.552,0.529,2,5,0.4,10,33,43,24,7,3,6,27,94
197,Herbert Jones,SF,24,NOP,9,9,269,33,71,0.465,2,18,0.111,31,53,0.585,0.479,26,33,0.788,12,20,32,18,10,5,9,33,94
198,Duncan Robinson,SF,28,MIA,14,0,246,32,91,0.352,21,68,0.309,11,23,0.478,0.467,9,10,0.9,3,28,31,18,1,0,7,24,94
199,Edmond Sumner,SG,27,BRK,12,6,207,32,75,0.427,9,30,0.3,23,45,0.511,0.487,21,22,0.955,4,18,22,18,12,4,16,16,94
200,Keita Bates-Diop,SF,27,SAS,13,3,177,35,71,0.493,6,18,0.333,29,53,0.547,0.535,16,19,0.842,17,18,35,7,7,0,14,6,92
201,Dalano Banton,PG,23,TOR,14,1,147,33,72,0.458,11,31,0.355,22,41,0.537,0.535,14,16,0.875,6,13,19,16,8,10,10,14,91
202,Damion Lee,SG,30,PHO,13,0,249,29,69,0.42,21,46,0.457,8,23,0.348,0.572,12,14,0.857,5,27,32,14,8,0,7,20,91
203,Evan Fournier,SG,30,NYK,13,7,260,31,90,0.344,19,57,0.333,12,33,0.364,0.45,9,11,0.818,2,25,27,22,9,3,14,28,90
204,Naji Marshall,SF,25,NOP,13,4,256,34,77,0.442,10,27,0.37,24,50,0.48,0.506,12,17,0.706,13,24,37,18,9,3,12,18,90
205,Steven Adams,C,29,MEM,13,13,352,40,65,0.615,0,0,,40,65,0.615,0.615,9,29,0.31,68,80,148,35,10,16,30,37,89
206,Mo Bamba,C,24,ORL,13,0,197,35,69,0.507,9,29,0.31,26,40,0.65,0.572,10,16,0.625,15,39,54,13,2,9,10,25,89
207,James Bouknight,SG,22,CHO,15,0,270,33,98,0.337,12,52,0.231,21,46,0.457,0.398,10,16,0.625,4,30,34,21,6,4,15,24,88
208,John Konchar,SG,26,MEM,13,5,336,34,77,0.442,19,48,0.396,15,29,0.517,0.565,1,2,0.5,19,53,72,14,13,4,6,21,88
209,Hamidou Diallo,SG,24,DET,15,0,210,31,77,0.403,1,8,0.125,30,69,0.435,0.409,24,35,0.686,17,26,43,11,8,2,11,32,87
210,Kevon Looney,C,26,GSW,14,14,336,39,64,0.609,0,0,,39,64,0.609,0.609,9,14,0.643,32,64,96,45,5,7,7,43,87
211,Justise Winslow,SF,26,POR,11,4,293,35,89,0.393,5,20,0.25,30,69,0.435,0.421,12,18,0.667,19,34,53,39,14,6,14,28,87
212,Nassir Little,PF,22,POR,13,0,199,33,61,0.541,13,28,0.464,20,33,0.606,0.648,7,12,0.583,4,28,32,12,4,2,7,9,86
213,Chuma Okeke,PF,24,ORL,14,3,294,28,68,0.412,16,46,0.348,12,22,0.545,0.529,13,17,0.765,20,41,61,22,6,7,8,25,85
214,Javonte Green,SG,29,CHI,14,0,244,32,59,0.542,8,21,0.381,24,38,0.632,0.61,12,15,0.8,16,29,45,13,16,10,10,30,84
215,Cam Thomas,SG,21,BRK,9,0,175,25,64,0.391,5,15,0.333,20,49,0.408,0.43,29,34,0.853,1,15,16,20,7,2,8,10,84
216,Jalen Williams,SG,21,OKC,10,3,228,37,67,0.552,5,21,0.238,32,46,0.696,0.59,5,6,0.833,3,22,25,24,9,4,13,26,84
217,Daniel Gafford,C,24,WAS,14,0,206,32,44,0.727,0,0,,32,44,0.727,0.727,18,29,0.621,20,35,55,8,5,15,17,23,82
218,R.J. Hampton,PG,21,ORL,12,0,178,27,53,0.509,12,24,0.5,15,29,0.517,0.623,16,17,0.941,6,12,18,16,9,4,12,14,82
219,Justin Holiday,SG,33,ATL,13,0,252,31,80,0.388,19,56,0.339,12,24,0.5,0.506,0,0,,1,15,16,15,4,4,8,25,81
220,Davion Mitchell,PG,24,SAC,12,1,226,33,72,0.458,13,37,0.351,20,35,0.571,0.549,2,3,0.667,1,15,16,21,6,0,16,20,81
221,Derrick Rose,PG,34,NYK,13,0,173,31,81,0.383,12,34,0.353,19,47,0.404,0.457,7,7,1,4,21,25,28,5,2,15,8,81
222,Chris Duarte,SF,25,IND,9,5,177,28,71,0.394,13,38,0.342,15,33,0.455,0.486,11,12,0.917,4,15,19,9,1,4,8,16,80
223,Killian Hayes,PG,21,DET,15,2,311,32,104,0.308,8,33,0.242,24,71,0.338,0.346,8,10,0.8,8,30,38,52,14,5,25,34,80
224,Jordan Nwora,SF,24,MIL,13,1,236,26,86,0.302,13,43,0.302,13,43,0.302,0.378,15,15,1,11,43,54,13,4,1,10,16,80
225,David Roddy,PF,21,MEM,14,0,251,31,83,0.373,11,44,0.25,20,39,0.513,0.44,7,10,0.7,12,26,38,9,7,5,7,21,80
226,Dean Wade,PF,26,CLE,11,4,251,27,51,0.529,18,36,0.5,9,15,0.6,0.706,8,11,0.727,5,31,36,11,6,4,4,27,80
227,Torrey Craig,SF,32,PHO,13,5,263,30,65,0.462,14,36,0.389,16,29,0.552,0.569,5,8,0.625,24,31,55,18,7,7,9,27,79
228,Moses Moody,SG,20,GSW,12,1,212,26,63,0.413,14,39,0.359,12,24,0.5,0.524,13,16,0.813,5,21,26,9,6,5,15,13,79
229,Mike Muscala,C,31,OKC,11,1,152,27,62,0.435,13,40,0.325,14,22,0.636,0.54,11,14,0.786,7,39,46,8,0,6,6,19,78
230,Isaiah Livers,PF,24,DET,13,0,250,23,64,0.359,19,52,0.365,4,12,0.333,0.508,12,16,0.75,10,26,36,8,4,6,7,26,77
231,Dewayne Dedmon,C,33,MIA,12,0,145,28,49,0.571,7,16,0.438,21,33,0.636,0.643,13,16,0.813,12,29,41,8,1,5,6,24,76
232,Patty Mills,PG,34,BRK,14,0,180,24,60,0.4,18,47,0.383,6,13,0.462,0.55,10,10,1,4,7,11,12,3,1,3,7,76
233,Naz Reid,C,23,MIN,9,0,118,31,53,0.585,6,20,0.3,25,33,0.758,0.642,8,12,0.667,6,18,24,3,4,7,7,17,76
234,Kenrich Williams,PF,28,OKC,13,2,266,33,68,0.485,7,23,0.304,26,45,0.578,0.537,3,9,0.333,24,29,53,22,9,2,4,24,76
235,MarJon Beauchamp,SF,22,MIL,10,4,181,28,65,0.431,12,37,0.324,16,28,0.571,0.523,7,10,0.7,10,27,37,4,6,2,12,21,75
236,Zach Collins,PF,25,SAS,9,0,159,31,59,0.525,7,18,0.389,24,41,0.585,0.585,6,9,0.667,12,30,42,25,6,11,17,27,75
237,Josh Green,SG,22,DAL,12,0,226,25,40,0.625,11,22,0.5,14,18,0.778,0.763,14,22,0.636,11,16,27,11,13,1,9,24,75
238,James Wiseman,C,21,GSW,11,0,147,30,51,0.588,0,0,,30,51,0.588,0.588,15,23,0.652,11,31,42,11,1,4,8,26,75
239,Jalen Duren,C,19,DET,12,0,254,32,57,0.561,0,1,0,32,56,0.571,0.561,10,28,0.357,34,53,87,4,4,14,13,24,74
240,Andrew Nembhard,SG,23,IND,11,3,221,27,64,0.422,14,35,0.4,13,29,0.448,0.531,5,5,1,4,21,25,37,8,1,12,24,73
241,Drew Eubanks,C,25,POR,13,3,227,29,42,0.69,0,0,,29,42,0.69,0.69,13,19,0.684,17,32,49,11,5,9,10,27,71
242,Terence Davis,SG,25,SAC,11,0,139,23,53,0.434,12,36,0.333,11,17,0.647,0.547,12,14,0.857,5,22,27,14,7,2,5,19,70
243,Aaron Holiday,PG,26,ATL,14,1,269,27,61,0.443,8,17,0.471,19,44,0.432,0.508,8,9,0.889,6,14,20,25,11,3,12,24,70
244,Andre Drummond,C,29,CHI,8,0,134,29,53,0.547,0,2,0,29,51,0.569,0.547,11,15,0.733,26,51,77,7,7,3,14,21,69
245,AJ Griffin,SF,19,ATL,10,0,126,27,53,0.509,12,26,0.462,15,27,0.556,0.623,3,3,1,5,11,16,6,6,0,5,9,69
246,Derrick Jones Jr.,SF,25,CHI,12,0,173,20,45,0.444,3,11,0.273,17,34,0.5,0.478,26,31,0.839,13,19,32,7,5,10,2,15,69
247,George Hill,PG,36,MIL,13,0,298,20,54,0.37,6,26,0.231,14,28,0.5,0.426,22,30,0.733,5,19,24,34,5,2,10,18,68
248,P.J. Tucker,PF,37,PHI,14,14,398,27,47,0.574,11,24,0.458,16,23,0.696,0.691,3,4,0.75,18,43,61,11,8,7,15,36,68
249,Théo Maledon,PG,21,CHO,14,0,198,24,44,0.545,8,20,0.4,16,24,0.667,0.636,11,13,0.846,1,29,30,31,7,3,15,16,67
250,Yuta Watanabe,SF,28,BRK,11,0,183,27,45,0.6,12,24,0.5,15,21,0.714,0.733,1,3,0.333,7,22,29,7,3,7,3,11,67
251,Darius Bazley,PF,22,OKC,11,0,184,27,64,0.422,7,18,0.389,20,46,0.435,0.477,5,11,0.455,18,34,52,17,9,14,6,16,66
252,Walker Kessler,C,21,UTA,12,0,176,28,42,0.667,0,0,,28,42,0.667,0.667,9,18,0.5,27,36,63,8,2,20,7,21,65
253,Devonte' Graham,PG,27,NOP,13,0,213,20,53,0.377,17,42,0.405,3,11,0.273,0.538,7,10,0.7,1,14,15,31,7,3,6,11,64
254,Aaron Wiggins,SG,24,OKC,11,4,228,23,54,0.426,7,20,0.35,16,34,0.471,0.491,11,14,0.786,9,35,44,21,6,4,9,19,64
255,Landry Shamet,SG,25,PHO,9,0,146,20,50,0.4,12,33,0.364,8,17,0.471,0.52,11,13,0.846,2,4,6,11,5,1,8,12,63
256,Cole Anthony,PG,22,ORL,4,3,122,22,53,0.415,7,20,0.35,15,33,0.455,0.481,11,15,0.733,3,16,19,17,3,3,8,14,62
257,Aaron Nesmith,SF,23,IND,8,4,169,22,53,0.415,9,28,0.321,13,25,0.52,0.5,9,11,0.818,3,23,26,14,2,7,9,22,62
258,Kyle Anderson,PF,29,MIN,10,2,193,22,40,0.55,6,13,0.462,16,27,0.593,0.625,11,13,0.846,4,25,29,29,8,5,8,12,61
259,Alex Caruso,PG,28,CHI,14,5,353,18,56,0.321,10,33,0.303,8,23,0.348,0.411,15,20,0.75,8,38,46,53,22,14,26,28,61
260,Jalen Johnson,SF,21,ATL,14,0,196,24,51,0.471,3,17,0.176,21,34,0.618,0.5,9,13,0.692,6,38,44,10,10,3,7,21,60
261,DeAndre Jordan,C,34,DEN,11,0,148,25,31,0.806,1,1,1,24,30,0.8,0.823,9,17,0.529,15,39,54,8,1,7,15,16,60
262,Christian Koloko,C,22,TOR,15,8,256,22,51,0.431,0,3,0,22,48,0.458,0.431,16,24,0.667,22,28,50,8,4,18,11,44,60
263,Jake LaRavia,PF,21,MEM,11,0,206,21,47,0.447,13,31,0.419,8,16,0.5,0.585,5,5,1,9,31,40,8,6,3,9,27,60
264,Trey Lyles,PF,27,SAC,10,0,143,20,51,0.392,14,39,0.359,6,12,0.5,0.529,6,9,0.667,4,21,25,10,4,5,10,12,60
265,Maxi Kleber,C,31,DAL,12,0,311,20,51,0.392,9,32,0.281,11,19,0.579,0.48,9,12,0.75,11,35,46,11,6,8,8,22,58
266,Malachi Flynn,PG,24,TOR,9,0,95,18,41,0.439,11,23,0.478,7,18,0.389,0.573,10,11,0.909,1,10,11,9,3,1,5,13,57
267,Jonathan Kuminga,PF,20,GSW,11,1,155,20,47,0.426,4,15,0.267,16,32,0.5,0.468,13,15,0.867,6,14,20,8,3,3,13,20,57
268,Dwight Powell,C,31,DAL,9,5,166,23,36,0.639,0,1,0,23,35,0.657,0.639,11,14,0.786,15,19,34,2,6,4,6,20,57
269,Coby White,PG,22,CHI,7,0,153,21,55,0.382,10,34,0.294,11,21,0.524,0.473,5,9,0.556,1,11,12,12,5,0,6,14,57
270,Nicolas Batum,PF,34,LAC,14,1,248,19,49,0.388,11,35,0.314,8,14,0.571,0.5,7,11,0.636,11,45,56,20,6,13,12,34,56
271,Reggie Bullock,SF,31,DAL,12,12,344,19,64,0.297,15,51,0.294,4,13,0.308,0.414,3,5,0.6,5,30,35,12,14,2,7,35,56
272,Jordan Goodwin,PG,24,WAS,8,0,151,22,40,0.55,8,15,0.533,14,25,0.56,0.65,3,4,0.75,10,24,34,25,6,7,5,13,55
273,JaMychal Green,PF,32,GSW,11,0,187,22,49,0.449,5,20,0.25,17,29,0.586,0.5,6,7,0.857,20,32,52,8,10,7,11,24,55
274,Rudy Gay,SF,36,UTA,12,0,189,21,58,0.362,9,34,0.265,12,24,0.5,0.44,3,6,0.5,6,35,41,10,5,6,10,16,54
275,Anthony Lamb,SF,25,GSW,6,1,123,21,34,0.618,12,22,0.545,9,12,0.75,0.794,0,0,,4,15,19,10,4,0,5,15,54
276,Corey Kispert,SF,23,WAS,6,5,145,19,34,0.559,8,18,0.444,11,16,0.688,0.676,7,8,0.875,0,13,13,10,5,0,4,7,53
277,Wenyen Gabriel,PF,25,LAL,11,2,149,22,35,0.629,1,5,0.2,21,30,0.7,0.643,7,10,0.7,7,21,28,8,8,6,8,23,52
278,Montrezl Harrell,C,29,PHI,12,1,131,18,32,0.563,0,0,,18,32,0.563,0.563,16,23,0.696,8,17,25,5,4,6,5,14,52
279,Kendrick Nunn,PG,27,LAL,11,2,148,21,68,0.309,8,35,0.229,13,33,0.394,0.368,2,3,0.667,1,15,16,14,2,1,15,10,52
280,Mitchell Robinson,C,24,NYK,8,8,174,23,33,0.697,0,0,,23,33,0.697,0.697,6,14,0.429,28,23,51,8,3,18,5,29,52
281,Patrick Beverley,PG,34,LAL,11,11,309,15,54,0.278,8,34,0.235,7,20,0.35,0.352,13,15,0.867,9,32,41,33,12,5,10,35,51
282,Anthony Gill,PF,30,WAS,13,4,173,21,37,0.568,2,9,0.222,19,28,0.679,0.595,6,6,1,10,14,24,9,3,1,2,21,50
283,Garrison Mathews,SG,26,HOU,13,0,154,14,42,0.333,14,41,0.341,0,1,0,0.5,8,8,1,1,10,11,5,4,1,5,15,50
284,Seth Curry,SG,32,BRK,5,0,97,17,40,0.425,11,27,0.407,6,13,0.462,0.563,4,5,0.8,1,7,8,11,3,1,2,8,49
285,Christian Braun,SG,21,DEN,12,0,188,19,40,0.475,6,16,0.375,13,24,0.542,0.55,4,6,0.667,7,19,26,14,6,2,5,11,48
286,Serge Ibaka,PF,33,MIL,11,0,130,18,34,0.529,5,12,0.417,13,22,0.591,0.603,7,11,0.636,10,26,36,3,0,6,7,17,48
287,Ty Jerome,SG,25,GSW,8,0,120,16,30,0.533,6,16,0.375,10,14,0.714,0.633,10,10,1,1,7,8,15,1,1,2,9,48
288,Danuel House Jr.,SF,29,PHI,12,0,202,15,35,0.429,7,21,0.333,8,14,0.571,0.529,10,14,0.714,4,16,20,10,6,3,6,17,47
289,Matt Ryan,SF,25,LAL,10,0,122,15,44,0.341,13,31,0.419,2,13,0.154,0.489,4,5,0.8,2,11,13,3,2,0,3,14,47
290,Ben Simmons,PG,26,BRK,9,6,245,20,45,0.444,0,1,0,20,44,0.455,0.444,7,15,0.467,10,46,56,53,10,5,20,37,47
291,Usman Garuba,PF,20,HOU,12,1,183,18,33,0.545,4,6,0.667,14,27,0.519,0.606,6,13,0.462,27,38,65,14,11,8,14,22,46
292,Wesley Matthews,SG,36,MIL,13,0,212,14,48,0.292,11,37,0.297,3,11,0.273,0.406,5,6,0.833,13,17,30,8,9,4,6,22,44
293,Otto Porter Jr.,SF,29,TOR,8,2,146,15,30,0.5,6,17,0.353,9,13,0.692,0.6,8,8,1,6,13,19,8,11,0,4,7,44
294,Eugene Omoruyi,SF,25,OKC,6,0,69,15,26,0.577,6,11,0.545,9,15,0.6,0.692,7,11,0.636,5,7,12,2,1,0,4,17,43
295,Thaddeus Young,PF,34,TOR,12,2,166,17,36,0.472,1,9,0.111,16,27,0.593,0.486,8,10,0.8,17,19,36,17,12,2,6,16,43
296,Keon Johnson,SG,20,POR,6,0,106,16,45,0.356,8,23,0.348,8,22,0.364,0.444,2,6,0.333,3,12,15,10,5,2,13,10,42
297,Cory Joseph,PG,31,DET,12,2,149,13,33,0.394,7,18,0.389,6,15,0.4,0.5,9,11,0.818,2,9,11,29,3,1,5,18,42
298,T.J. McConnell,PG,30,IND,11,0,175,20,53,0.377,0,2,0,20,51,0.392,0.377,2,3,0.667,6,19,25,36,13,3,18,13,42
299,JaVale McGee,C,35,DAL,10,7,94,16,32,0.5,0,0,,16,32,0.5,0.5,10,17,0.588,11,19,30,2,3,5,11,10,42
300,Daishen Nix,PG,20,HOU,12,0,167,14,36,0.389,11,24,0.458,3,12,0.25,0.542,3,4,0.75,3,13,16,27,9,1,17,9,42
301,Isaiah Joe,SG,23,OKC,11,0,67,13,25,0.52,8,19,0.421,5,6,0.833,0.68,5,7,0.714,0,12,12,6,3,1,4,8,39
302,Shake Milton,SG,26,PHI,10,0,124,17,37,0.459,1,7,0.143,16,30,0.533,0.473,4,6,0.667,5,15,20,14,0,2,12,14,39
303,Kevon Harris,SG,25,ORL,10,0,134,11,33,0.333,5,12,0.417,6,21,0.286,0.409,11,14,0.786,10,14,24,5,4,0,8,17,38
304,Jordan McLaughlin,PG,26,MIN,12,0,187,15,40,0.375,2,19,0.105,13,21,0.619,0.4,6,6,1,4,20,24,46,6,1,8,6,38
305,Chimezie Metu,C,25,SAC,8,0,93,16,32,0.5,1,10,0.1,15,22,0.682,0.516,5,6,0.833,2,18,20,8,3,1,2,8,38
306,Payton Pritchard,PG,25,BOS,7,0,74,15,33,0.455,5,15,0.333,10,18,0.556,0.53,2,4,0.5,8,7,15,8,3,0,9,3,37
307,Goga Bitadze,C,23,IND,8,0,105,14,27,0.519,1,7,0.143,13,20,0.65,0.537,7,14,0.5,13,14,27,12,4,4,6,18,36
308,Bismack Biyombo,C,30,PHO,11,2,130,15,27,0.556,0,0,,15,27,0.556,0.556,6,9,0.667,8,28,36,6,2,19,7,20,36
309,JT Thor,PF,20,CHO,13,0,143,12,38,0.316,4,20,0.2,8,18,0.444,0.368,7,9,0.778,8,20,28,8,3,5,9,7,35
310,Caleb Houstan,SF,20,ORL,10,0,172,11,31,0.355,7,22,0.318,4,9,0.444,0.468,5,6,0.833,5,15,20,5,2,1,4,14,34
311,Isaac Okoro,SG,22,CLE,13,3,205,12,36,0.333,1,14,0.071,11,22,0.5,0.347,9,12,0.75,5,14,19,5,7,1,11,26,34
312,Charles Bassey,C,22,SAS,5,0,86,13,21,0.619,2,5,0.4,11,16,0.688,0.667,5,6,0.833,14,25,39,10,3,10,7,14,33
313,Robert Covington,PF,32,LAC,8,0,119,10,25,0.4,6,17,0.353,4,8,0.5,0.52,7,8,0.875,2,25,27,9,3,6,5,19,33
314,LaMelo Ball,PG,21,CHO,2,2,62,12,36,0.333,5,24,0.208,7,12,0.583,0.403,3,3,1,0,10,10,15,1,1,7,7,32
315,Alec Burks,SG,31,DET,2,0,42,10,19,0.526,3,8,0.375,7,11,0.636,0.605,9,13,0.692,0,4,4,3,1,0,1,6,32
316,Josh Christopher,SG,21,HOU,10,0,85,14,37,0.378,3,14,0.214,11,23,0.478,0.419,1,2,0.5,4,11,15,7,3,0,8,10,32
317,Richaun Holmes,PF,29,SAC,8,0,102,14,20,0.7,0,0,,14,20,0.7,0.7,4,6,0.667,8,15,23,0,2,1,5,15,32
318,Isaiah Roby,PF,24,SAS,9,0,96,12,30,0.4,3,11,0.273,9,19,0.474,0.45,4,10,0.4,3,17,20,12,5,3,3,7,31
319,Ousmane Dieng,SF,19,OKC,9,0,135,12,36,0.333,5,22,0.227,7,14,0.5,0.403,1,2,0.5,3,17,20,15,1,2,3,5,30
320,Luke Kornet,C,27,BOS,10,0,117,11,21,0.524,1,3,0.333,10,18,0.556,0.548,7,8,0.875,13,17,30,12,2,8,6,14,30
321,Romeo Langford,SG,23,SAS,7,2,114,13,31,0.419,1,7,0.143,12,24,0.5,0.435,3,4,0.75,10,4,14,3,3,2,5,10,30
322,Robin Lopez,C,34,CLE,8,0,75,13,18,0.722,0,0,,13,18,0.722,0.722,4,6,0.667,7,6,13,3,0,2,4,7,30
323,Duane Washington Jr.,SG,22,PHO,6,0,36,12,29,0.414,6,16,0.375,6,13,0.462,0.517,0,0,,0,0,0,5,0,0,2,1,30
324,David Duke Jr.,SG,23,BRK,8,0,77,13,27,0.481,0,4,0,13,23,0.565,0.481,3,3,1,4,6,10,5,4,1,6,15,29
325,Raul Neto,PG,30,CLE,8,0,91,10,25,0.4,3,9,0.333,7,16,0.438,0.46,6,6,1,2,10,12,13,4,0,4,6,29
326,Joshua Primo,SG,20,SAS,4,0,93,9,26,0.346,3,12,0.25,6,14,0.429,0.404,7,9,0.778,2,11,13,18,1,2,11,8,28
327,Xavier Tillman Sr.,PF,24,MEM,8,0,91,12,23,0.522,1,4,0.25,11,19,0.579,0.543,3,9,0.333,11,12,23,6,0,2,7,8,28
328,Gorgui Dieng,C,33,SAS,7,0,64,9,21,0.429,6,17,0.353,3,4,0.75,0.571,3,4,0.75,6,9,15,12,1,4,7,9,27
329,Damian Jones,C,27,LAL,9,1,75,10,21,0.476,0,1,0,10,20,0.5,0.476,7,10,0.7,9,15,24,3,1,4,5,10,27
330,Nickeil Alexander-Walker,SG,24,UTA,9,0,70,9,27,0.333,4,13,0.308,5,14,0.357,0.407,4,5,0.8,0,6,6,10,5,3,5,11,26
331,Amir Coffey,SG,25,LAC,12,0,107,6,19,0.316,1,4,0.25,5,15,0.333,0.342,13,16,0.813,3,6,9,7,3,1,3,7,26
332,Bryn Forbes,SG,29,MIN,8,0,87,9,29,0.31,4,14,0.286,5,15,0.333,0.379,4,4,1,3,2,5,8,7,0,3,5,26
333,Juan Toscano-Anderson,SF,29,LAL,10,0,123,10,25,0.4,2,11,0.182,8,14,0.571,0.44,4,5,0.8,1,20,21,5,3,3,8,17,26
334,Delon Wright,PG,30,WAS,4,0,91,10,24,0.417,3,12,0.25,7,12,0.583,0.479,3,5,0.6,4,6,10,13,11,4,4,5,26
335,Max Christie,SG,19,LAL,8,0,92,8,17,0.471,6,11,0.545,2,6,0.333,0.647,3,4,0.75,1,20,21,4,3,0,2,4,25
336,Donte DiVincenzo,SG,26,GSW,6,0,90,8,18,0.444,4,12,0.333,4,6,0.667,0.556,5,6,0.833,0,8,8,10,2,0,11,11,25
337,Kawhi Leonard,SF,31,LAC,2,0,42,8,18,0.444,1,6,0.167,7,12,0.583,0.472,8,9,0.889,4,9,13,4,3,0,4,5,25
338,Jae'Sean Tate,SF,27,HOU,3,2,68,10,20,0.5,2,5,0.4,8,15,0.533,0.55,3,4,0.75,8,5,13,10,3,0,5,15,25
339,Trendon Watford,PF,22,POR,5,0,92,9,20,0.45,0,4,0,9,16,0.563,0.45,7,8,0.875,3,13,16,13,6,0,7,13,25
340,Malaki Branham,SF,19,SAS,4,2,78,8,28,0.286,3,15,0.2,5,13,0.385,0.339,5,6,0.833,2,7,9,8,1,0,3,3,24
341,Moses Brown,C,23,LAC,8,0,32,10,13,0.769,0,0,,10,13,0.769,0.769,4,7,0.571,5,8,13,0,0,4,0,4,24
342,Blake Griffin,PF,33,BOS,6,2,72,8,18,0.444,3,8,0.375,5,10,0.5,0.528,5,6,0.833,6,12,18,5,2,0,4,10,24
343,Day'Ron Sharpe,C,21,BRK,10,0,89,9,21,0.429,0,1,0,9,20,0.45,0.429,6,10,0.6,10,22,32,6,3,5,8,21,24
344,Juancho Hernangómez,PF,27,TOR,8,0,90,9,18,0.5,4,10,0.4,5,8,0.625,0.611,1,2,0.5,4,18,22,9,4,2,4,7,23
345,Jericho Sims,C,24,NYK,8,2,88,11,11,1,0,0,,11,11,1,1,1,2,0.5,10,14,24,1,1,6,2,15,23
346,Noah Vonleh,C,27,BOS,12,1,127,10,19,0.526,1,2,0.5,9,17,0.529,0.553,2,2,1,16,20,36,4,2,6,9,27,23
347,Jabari Walker,SF,20,POR,8,0,72,9,17,0.529,1,5,0.2,8,12,0.667,0.559,4,6,0.667,5,15,20,8,1,1,2,6,23
348,Dyson Daniels,PG,19,NOP,5,0,47,7,12,0.583,3,5,0.6,4,7,0.571,0.708,4,6,0.667,3,8,11,6,3,2,3,4,21
349,Lamar Stevens,PF,25,CLE,4,1,53,7,15,0.467,0,2,0,7,13,0.538,0.467,7,8,0.875,2,5,7,1,0,1,1,6,21
350,Ochai Agbaji,SG,22,UTA,6,0,67,8,19,0.421,0,6,0,8,13,0.615,0.421,4,7,0.571,4,6,10,1,0,0,0,6,20
351,Marvin Bagley III,PF,23,DET,2,1,46,8,16,0.5,1,3,0.333,7,13,0.538,0.531,3,3,1,5,4,9,1,1,2,2,3,20
352,Markieff Morris,PF,33,BRK,8,0,77,7,22,0.318,6,15,0.4,1,7,0.143,0.455,0,0,,2,14,16,9,2,2,7,10,20
353,Matisse Thybulle,SG,25,PHI,13,3,170,8,27,0.296,3,16,0.188,5,11,0.455,0.352,1,3,0.333,4,16,20,8,13,5,2,17,20
354,Terry Taylor,SG,23,IND,8,2,94,7,21,0.333,2,8,0.25,5,13,0.385,0.381,3,4,0.75,6,9,15,5,2,4,1,9,19
355,Dario Šarić,PF,28,PHO,7,0,63,7,23,0.304,2,9,0.222,5,14,0.357,0.348,1,2,0.5,9,11,20,6,3,0,3,8,17
356,Bryce McGowens,SG,20,CHO,5,0,30,5,9,0.556,1,3,0.333,4,6,0.667,0.611,5,5,1,0,2,2,1,2,1,1,1,16
357,Zeke Nnaji,PF,22,DEN,8,0,31,7,13,0.538,0,3,0,7,10,0.7,0.538,2,2,1,4,3,7,0,2,0,2,9,16
358,Blake Wesley,SG,19,SAS,2,0,23,6,9,0.667,2,3,0.667,4,6,0.667,0.778,2,4,0.5,1,1,2,4,0,0,2,3,16
359,Simone Fontecchio,SF,27,UTA,7,0,32,6,16,0.375,3,11,0.273,3,5,0.6,0.469,0,0,,2,4,6,0,1,0,3,5,15
360,Taj Gibson,PF,37,WAS,6,0,27,5,11,0.455,1,4,0.25,4,7,0.571,0.5,4,4,1,2,4,6,3,1,0,1,3,15
361,Davon Reed,SG,27,DEN,9,0,52,5,15,0.333,4,7,0.571,1,8,0.125,0.467,1,2,0.5,0,4,4,1,3,0,8,5,15
362,Oshae Brissett,SF,24,IND,7,0,66,5,17,0.294,1,10,0.1,4,7,0.571,0.324,3,4,0.75,4,7,11,2,1,0,4,2,14
363,Kennedy Chandler,PG,20,MEM,6,0,58,6,19,0.316,1,6,0.167,5,13,0.385,0.342,1,4,0.25,1,5,6,12,2,2,6,3,14
364,Kevin Knox,SF,23,DET,8,0,65,6,24,0.25,2,16,0.125,4,8,0.5,0.292,0,0,,2,6,8,1,1,1,4,10,14
365,Furkan Korkmaz,SG,25,PHI,5,0,28,4,8,0.5,1,3,0.333,3,5,0.6,0.563,5,6,0.833,1,3,4,3,0,0,2,2,14
366,Brandon Boston Jr.,SG,21,LAC,5,0,16,5,10,0.5,2,3,0.667,3,7,0.429,0.6,1,2,0.5,1,1,2,0,0,0,0,1,13
367,Willy Hernangómez,C,28,NOP,3,0,26,5,11,0.455,0,2,0,5,9,0.556,0.455,2,2,1,4,8,12,1,1,0,5,3,12
368,Josh Okogie,SG,24,PHO,12,0,63,4,14,0.286,0,7,0,4,7,0.571,0.286,4,6,0.667,3,11,14,1,4,2,5,8,12
369,Ryan Rollins,PG,20,GSW,5,0,21,4,8,0.5,2,3,0.667,2,5,0.4,0.625,2,2,1,0,3,3,2,0,0,7,6,12
370,Khem Birch,C,30,TOR,5,0,38,4,6,0.667,1,1,1,3,5,0.6,0.75,2,2,1,3,2,5,2,3,1,2,10,11
371,Bruno Fernando,C,24,HOU,2,2,37,5,6,0.833,0,0,,5,6,0.833,0.833,1,2,0.5,5,8,13,9,1,2,1,3,11
372,James Johnson,PF,35,IND,3,0,44,5,12,0.417,1,5,0.2,4,7,0.571,0.458,0,0,,0,7,7,4,1,2,0,10,11
373,Kai Jones,C,22,CHO,7,0,28,4,7,0.571,1,3,0.333,3,4,0.75,0.643,2,4,0.5,0,1,1,2,1,6,0,2,11
374,Nerlens Noel,C,28,DET,4,0,54,4,12,0.333,0,0,,4,12,0.333,0.333,3,4,0.75,2,13,15,3,3,1,3,5,11
375,Mark Williams,C,21,CHO,3,0,13,4,7,0.571,0,0,,4,7,0.571,0.571,3,3,1,4,4,8,0,0,0,2,3,11
376,Udoka Azubuike,C,23,UTA,5,0,20,5,6,0.833,0,0,,5,6,0.833,0.833,0,0,,2,7,9,1,2,2,2,1,10
377,Greg Brown III,PF,21,POR,4,0,22,5,7,0.714,0,0,,5,7,0.714,0.714,0,5,0,0,1,1,0,3,2,2,3,10
378,Quentin Grimes,SG,22,NYK,5,1,40,3,9,0.333,2,8,0.25,1,1,1,0.444,2,2,1,1,2,3,2,0,1,2,6,10
379,Frank Kaminsky,C,29,ATL,5,0,28,3,5,0.6,0,1,0,3,4,0.75,0.6,4,4,1,0,6,6,3,0,0,1,7,10
380,Tyler Dorsey,SG,26,DAL,1,0,4,4,4,1,1,1,1,3,3,1,1.125,0,0,,1,1,2,0,0,0,0,0,9
381,Jordan Hall,SF,21,SAS,4,0,43,4,12,0.333,1,6,0.167,3,6,0.5,0.375,0,0,,1,3,4,6,1,0,4,4,9
382,Nikola Jović,PF,19,MIA,4,0,24,4,8,0.5,1,4,0.25,3,4,0.75,0.563,0,0,,1,1,2,1,2,0,2,5,9
383,Kenneth Lofton Jr.,PF,20,MEM,3,0,14,4,9,0.444,0,1,0,4,8,0.5,0.444,1,3,0.333,1,1,2,1,0,0,0,3,9
384,Svi Mykhailiuk,SF,25,NYK,3,0,6,3,3,1,3,3,1,0,0,,1.5,0,1,0,0,2,2,0,0,0,1,0,9
385,Austin Rivers,SG,30,MIN,7,0,44,2,9,0.222,1,5,0.2,1,4,0.25,0.278,4,4,1,0,4,4,2,0,1,1,1,9
386,Dalen Terry,SG,20,CHI,8,0,28,3,10,0.3,1,3,0.333,2,7,0.286,0.35,2,2,1,0,2,2,4,1,2,4,2,9
387,Matthew Dellavedova,PG,32,SAC,3,0,29,3,7,0.429,2,3,0.667,1,4,0.25,0.571,0,0,,1,1,2,4,1,0,2,5,8
388,Jeff Dowtin,PG,25,TOR,3,0,23,4,7,0.571,0,1,0,4,6,0.667,0.571,0,0,,2,3,5,4,0,1,1,2,8
389,Vit Krejci,PG,22,ATL,6,0,14,3,5,0.6,2,4,0.5,1,1,1,0.8,0,0,,0,2,2,1,0,0,0,2,8
390,Admiral Schofield,PF,25,ORL,5,0,32,3,6,0.5,2,5,0.4,1,1,1,0.667,0,0,,0,5,5,0,0,0,0,5,8
391,Jaylin Williams,PF,20,OKC,3,0,21,4,9,0.444,0,2,0,4,7,0.571,0.444,0,1,0,5,5,10,2,1,0,0,3,8
392,Sandro Mamukelashvili,C,23,MIL,5,0,25,3,10,0.3,1,5,0.2,2,5,0.4,0.35,0,0,,2,5,7,1,0,0,1,1,7
393,Boban Marjanović,C,34,HOU,6,0,19,2,4,0.5,0,0,,2,4,0.5,0.5,3,5,0.6,1,5,6,1,1,0,2,1,7
394,Tyrese Martin,SG,23,ATL,6,0,15,3,5,0.6,1,2,0.5,2,3,0.667,0.7,0,0,,1,0,1,0,1,0,0,1,7
395,Vlatko Čančar,PF,25,DEN,6,0,16,2,4,0.5,2,3,0.667,0,1,0,0.75,0,0,,0,2,2,0,0,0,1,1,6
396,Justin Champagnie,SF,21,TOR,2,0,9,3,3,1,0,0,,3,3,1,1,0,0,,1,2,3,0,0,0,0,1,6
397,Johnny Davis,SG,20,WAS,5,0,30,2,7,0.286,0,1,0,2,6,0.333,0.286,2,2,1,1,3,4,2,0,0,1,8,6
398,Justin Jackson,SF,27,BOS,3,0,15,2,6,0.333,2,5,0.4,0,1,0,0.5,0,0,,0,1,1,1,0,0,0,2,6
399,Paul Reed,C,23,PHI,11,0,79,3,13,0.231,0,2,0,3,11,0.273,0.231,0,0,,5,13,18,1,11,5,3,20,6
400,Garrett Temple,SG,36,NOP,2,0,21,2,4,0.5,2,4,0.5,0,0,,0.75,0,0,,0,1,1,1,1,0,0,2,6
401,Peyton Watson,SG,20,DEN,4,0,9,3,7,0.429,0,0,,3,7,0.429,0.429,0,0,,2,1,3,0,0,0,0,1,6
402,Rodney McGruder,SG,31,DET,5,0,21,1,7,0.143,1,4,0.25,0,3,0,0.214,2,2,1,2,2,4,1,0,0,0,1,5
403,Jaden Springer,PG,20,PHI,2,0,4,2,3,0.667,0,0,,2,3,0.667,0.667,1,2,0.5,1,1,2,0,0,1,0,1,5
404,Leandro Bolmaro,SG,22,UTA,3,0,21,2,7,0.286,0,2,0,2,5,0.4,0.286,0,0,,1,0,1,2,2,1,2,4,4
405,Braxton Key,SF,25,DET,2,0,7,1,1,1,0,0,,1,1,1,1,2,2,1,0,1,1,0,0,0,0,0,4
406,Micah Potter,PF,24,UTA,2,0,12,2,2,1,0,0,,2,2,1,1,0,0,,1,2,3,1,0,0,0,2,4
407,Ish Smith,PG,34,DEN,5,0,23,2,8,0.25,0,1,0,2,7,0.286,0.25,0,0,,0,2,2,2,0,1,4,4,4
408,Jamal Cain,SF,23,MIA,1,0,2,1,1,1,1,1,1,0,0,,1.5,0,0,,0,0,0,0,1,0,0,0,3
409,Facundo Campazzo,PG,31,DAL,3,0,16,1,4,0.25,1,3,0.333,0,1,0,0.375,0,0,,0,0,0,3,3,0,0,1,3
410,Moussa Diabaté,PF,21,LAC,2,0,6,1,1,1,0,0,,1,1,1,1,1,1,1,0,2,2,1,1,0,0,0,3
411,Kessler Edwards,SF,22,BRK,6,0,16,1,5,0.2,1,3,0.333,0,2,0,0.3,0,0,,0,2,2,2,1,0,0,0,3
412,Udonis Haslem,PF,42,MIA,2,0,10,1,3,0.333,0,0,,1,3,0.333,0.333,1,2,0.5,0,2,2,0,0,1,0,1,3
413,Trevor Hudgins,PG,23,HOU,1,0,4,1,1,1,1,1,1,0,0,,1.5,0,0,,0,0,0,0,0,0,0,0,3
414,Nathan Knight,PF,25,MIN,5,0,13,1,2,0.5,0,1,0,1,1,1,0.5,1,1,1,0,5,5,0,2,0,1,2,3
415,Isaiah Mobley,PF,23,CLE,1,0,4,1,1,1,1,1,1,0,0,,1.5,0,0,,0,1,1,0,0,0,0,1,3
416,KZ Okpala,PF,23,SAC,6,3,39,1,5,0.2,1,4,0.25,0,1,0,0.3,0,0,,2,4,6,2,0,0,0,4,3
417,Scotty Pippen Jr.,PG,22,LAL,2,0,8,0,2,0,0,0,,0,2,0,0,3,4,0.75,1,1,2,0,0,0,1,2,3
418,Jordan Schakel,SF,24,WAS,2,0,6,1,2,0.5,1,1,1,0,1,0,0.75,0,0,,0,0,0,1,1,0,0,1,3
419,Lindy Waters III,SG,25,OKC,2,0,16,1,6,0.167,1,6,0.167,0,0,,0.25,0,0,,1,1,2,0,0,0,0,0,3
420,Dominick Barlow,SF,19,SAS,1,0,10,1,3,0.333,0,2,0,1,1,1,0.333,0,0,,0,1,1,3,0,0,0,2,2
421,Tony Bradley,C,25,CHI,4,0,10,0,1,0,0,1,0,0,0,,0,2,2,1,1,4,5,0,0,0,0,0,2
422,John Butler,C,20,POR,1,0,9,1,2,0.5,0,1,0,1,1,1,0.5,0,0,,0,1,1,0,0,1,0,0,2
423,Mamadi Diakite,PF,26,CLE,3,0,8,1,3,0.333,0,2,0,1,1,1,0.333,0,0,,0,2,2,0,1,0,0,2,2
424,Jaxson Hayes,C,22,NOP,5,0,37,1,5,0.2,0,2,0,1,3,0.333,0.2,0,2,0,1,4,5,3,1,1,1,5,2
425,Haywood Highsmith,SF,26,MIA,6,0,29,1,6,0.167,0,4,0,1,2,0.5,0.167,0,0,,0,4,4,0,3,0,3,1,2
426,Theo Pinson,SG,27,DAL,2,0,7,0,0,,0,0,,0,0,,,2,2,1,0,2,2,1,0,0,0,0,2
427,Dru Smith,SG,25,MIA,1,0,6,1,3,0.333,0,2,0,1,1,1,0.333,0,0,,0,1,1,0,1,0,0,1,2
428,Isaiah Todd,PF,21,WAS,3,0,9,1,3,0.333,0,2,0,1,1,1,0.333,0,0,,0,0,0,0,0,0,0,0,2
429,Vince Williams Jr.,SG,22,MEM,3,0,18,1,6,0.167,0,5,0,1,1,1,0.167,0,0,,1,2,3,2,2,1,0,4,2
430,McKinley Wright IV,PG,24,DAL,1,0,5,1,4,0.25,0,1,0,1,3,0.333,0.25,0,0,,1,1,2,2,1,0,0,0,2
431,Jarrett Culver,SG,23,ATL,2,0,3,0,1,0,0,0,,0,1,0,0,1,2,0.5,1,0,1,0,0,0,0,0,1
432,Alex Len,C,29,SAC,3,0,8,0,1,0,0,0,,0,1,0,0,1,2,0.5,0,2,2,0,0,0,0,2,1
433,TyTy Washington Jr.,PG,21,HOU,1,0,4,0,0,,0,0,,0,0,,,1,2,0.5,0,0,0,0,0,0,0,0,1
434,Thanasis Antetokounmpo,SF,30,MIL,7,0,19,0,1,0,0,0,,0,1,0,0,0,0,,1,4,5,1,0,1,1,2,0
435,Ryan Arcidiacono,PG,28,NYK,3,0,6,0,1,0,0,1,0,0,0,,0,0,0,,0,2,2,1,1,0,0,1,0
436,Patrick Baldwin Jr.,SF,20,GSW,2,0,5,0,1,0,0,1,0,0,0,,0,0,0,,0,0,0,0,0,0,0,0,0
437,Buddy Boeheim,PG,23,DET,1,0,1,0,0,,0,0,,0,0,,,0,0,,0,0,0,0,0,0,0,0,0
438,Vernon Carey Jr.,C,21,WAS,2,0,2,0,0,,0,0,,0,0,,,0,0,,0,0,0,0,0,0,0,1,0
439,JD Davison,PG,20,BOS,1,0,2,0,0,,0,0,,0,0,,,0,0,,0,1,1,1,0,0,0,0,0
440,Trent Forrest,PG,24,ATL,4,0,14,0,3,0,0,0,,0,3,0,0,0,0,,0,2,2,3,0,0,0,1,0
441,A.J. Green,SG,23,MIL,1,0,2,0,0,,0,0,,0,0,,,0,0,,0,0,0,1,0,0,0,0,0
442,Jaden Hardy,SG,20,DAL,3,0,10,0,5,0,0,2,0,0,3,0,0,0,0,,0,2,2,1,0,0,2,2,0
443,Ron Harper Jr.,SF,22,TOR,1,0,3,0,1,0,0,1,0,0,0,,0,0,0,,0,0,0,0,0,0,0,0,0
444,Malcolm Hill,SF,27,CHI,3,0,1,0,0,,0,0,,0,0,,,0,0,,0,1,1,0,0,0,0,0,0
445,Trevor Keels,SG,19,NYK,1,0,1,0,1,0,0,1,0,0,0,,0,0,0,,0,1,1,0,0,0,0,0,0
446,Cody Martin,SF,27,CHO,1,0,1,0,0,,0,0,,0,0,,,0,0,,0,0,0,0,0,0,0,0,0
447,Miles McBride,PG,22,NYK,4,0,10,0,2,0,0,2,0,0,0,,0,0,2,0,0,0,0,2,0,0,0,1,0
448,Chima Moneke,SF,27,SAC,1,0,6,0,1,0,0,0,,0,1,0,0,0,2,0,2,0,2,1,0,0,0,2,0
449,Wendell Moore Jr.,SG,21,MIN,1,0,2,0,1,0,0,1,0,0,0,,0,0,0,,0,0,0,0,0,0,1,0,0
450,Frank Ntilikina,PG,24,DAL,1,0,4,0,3,0,0,3,0,0,0,,0,0,0,,0,2,2,1,0,0,0,0,0
451,Jason Preston,PG,23,LAC,1,0,3,0,1,0,0,1,0,0,0,,0,0,2,0,0,0,0,0,0,0,0,0,0
452,Dereon Seabron,SG,22,NOP,2,0,3,0,0,,0,0,,0,0,,,0,0,,0,0,0,0,0,0,0,0,0
453,Marko Simonovic,C,23,CHI,1,0,2,0,1,0,0,1,0,0,0,,0,0,0,,0,0,0,0,0,0,0,0,0
